丽江	玉龙雪山,龙泉寺,丽江古城,束河古镇,木府	牦牛肉,洋芋鸡,丽江雪桃,牦牛酸奶,松菌	茶马古道,火把节,纳西族,丽江木氏土司,印象·丽江
邯郸	娲皇宫,晋冀鲁豫烈士陵园,邺城遗址,兰陵王墓,邯郸道	大名二毛烧鸡,丛台酒,大名五百居香肠,魏县鸭梨,涉县核桃	荀子,杨氏太极拳,完璧归赵,皮影戏,将相和
大连	发现王国主题公园,星海广场,大连老虎滩海洋公园,黄金海岸,大连森林动物园	疙瘩汤,大连铁板鱿鱼,章鱼烧,油爆海螺,三鲜焖子	大连话,剪纸,足球,农民画,南戏
常州	东坡公园,舣舟亭,中华恐龙园,淹城,天宁寺	蟹壳黄,小笼包,酒酿圆子,乌米饭,虾饼	吴语,常州梳篦,留青竹刻,常州花博会,常州吟诵
襄阳	襄阳城,古隆中,诸葛亮广场,诸葛亮故居,九连墩	牛油面,襄阳黄酒,宜城大虾,襄阳大头菜,襄阳缠蹄	诸葛亮文化旅游节,孔明锁,老河口木版年画,水淹七军,端公舞
赣州	三僚风水文化景区,赣州古浮桥,将军园,赣州古城墙,梅关古道	梅菜扣肉,酿豆腐,盐焗鸡,兴国鱼丝,赣南脐橙	傩戏,兴国山歌,赣州脐橙节,哭嫁,赣州话
东莞	虎门炮台,可园,鸦片战争博物馆,迎恩门城楼,村头村遗址	白糖糕,东江盐焗鸡,石碣龙眼,麻涌香蕉,东坑糖不甩	粤语,荔枝节,粤曲,莞邑醒狮艺术,东莞龙舟竞渡
深圳	世界之窗,深圳东部华侨城,深圳欢乐谷,深圳音乐厅,新安故城	白切鸡,沙井鲜蚝,下沙大盆菜,公明烧鹅,红烧光明乳鸽	广府文化,设计之都,深圳读书月,中国（深圳）国际文化产业博览交易会,深圳客家文化节
定安	海南热带飞禽世界,南丽湖,文笔峰,母瑞山,母瑞山革命纪念园	斋菜煲,定安黑猪,海南煎棕,伊面,菜包饭	海南话,苗语,苗族,黎语,黎族
温州	望海楼,雁荡山,洞头列岛,楠溪江,江心屿	炒粉干,楠溪江麦饼,灯盏糕,长人馄饨,矮人松糕	吴语,芥菜饭,温州话,吃巧食,浙南闽语
澄迈	金山寺,美榔双塔,双滩赴海,济公山旅游度假区,加笼坪热带季雨林旅游区	海南粉,瑞溪粽子,白莲鹅,澄迈苦丁茶,福山咖啡	闽南语,闽语,海南话,苗语,黎语
琼中	白沙起义纪念园,百花岭,黎母山,黎母山森林公园,百花岭瀑布	椰子饭,琼中山鸡,绿橙,琼中山矾,橙汁扣小黄牛	海南话,苗语,琼中县志,黎语,琼中黎族民歌
苏州	拙政园,寒山寺,金鸡湖景区,狮子林,周庄景区	生煎,响油鳝糊,梅花糕,清炒虾仁,松鼠桂鱼	昆曲,太湖,苏州话,苏州园林,苏绣
五指山	黎母山,五指山风景区,万泉河,五指山,五指山大峡谷	清补凉,龙眼,荔枝,山兰酒,芒果	海南话,三月三,我爱五指山,五指山之恋,黎族船形屋
陵水	香水湾,苏维埃旧址,吊罗山,吊罗山国家森林公园,椰田古寨	陵水酸粉,琵琶蟹,圣女果,酸粉,黄灯笼辣椒	粤语,海南话,客家话,苗语,黎语
泉州	西湖公园,开元寺,安平桥,清源山,洛阳桥	卤肉饭,面线糊,肉粽,土笋冻,蚵仔煎	妈祖,南音,闽南语,高甲戏,歌仔戏
琼海	博鳌海洋馆,万泉河,龙湾港,玉带滩,红色娘子军纪念园	盐焗鸡,椰子饭,加积鸭,嘉积鸭,椰丝糯米粑	军坡节,南汉草席,千秋八仙桌,万泉河龙舟赛,博鳌亚洲论坛
洛阳	白云山,丝绸之路,花果山,龙门石窟,老君山	胡辣汤,羊肉汤,浆面条,肉夹馍,丸子汤	牡丹文化,洛阳铲,河图洛书,老子文化,河洛文化
上海	外滩,东方明珠广播电视塔,杜莎夫人蜡像馆,上海迪士尼乐园,文庙	南翔小笼,生煎,蟹壳黄,阳春面,排骨年糕	越剧,孙雯,旗袍,弄堂,海派文化
宝鸡	凤翔东湖,法门寺,太白山,灵山,炎帝陵	锅盔,臊子面,biangbiang面,肉夹馍,擀面皮	青铜器,明修栈道，暗度陈仓,血社火,西府海棠,凤鸣岐山
珠海	珠海渔女像,情侣路,长隆海洋王国,圆明新园,银沙滩	黄杨荔枝,横琴蚝,珠海膏蟹,小托山桔,斗门重壳蟹	粤语,广府文化,珠海格力电器股份有限公司,广府民系,浪漫之城
文昌	海底村庄,铜鼓岭,八门湾红树林国家湿地公园,七洲列岛,文昌孔庙	清补凉,盐焗鸡,文昌鸡,老爸茶,红糖年糕	骑楼,妈祖,闽南语,琼剧,海南岛欢乐节
屯昌	木色旅游度假风景区,木色湖,南吕岭探险旅游区,西昌银岭山洞探险旅游区,洪斗坡白鹭鸟乐园	椰子,芒果,竹筒饭,珍珠石榴,五色饭	闽南语,军坡节,海南话,苗族,斗牛
保亭	呀诺达热带雨林景区,槟榔谷,保亭千龙洞,毛感千龙洞,仙龙洞	椰子饭,海南粉,芒果,竹筒饭,琼式月饼	海南话,苗语,黎族织锦,黎语,舂米舞
黔南	大七孔桥,邓恩铭故居,百子桥,荔波樟江风景名胜区	丝娃娃,酸汤,凯里酸汤鱼,荔波风猪,冲冲糕	
安顺	黄果树瀑布,龙宫,黄果树,西江苗寨,紫云格凸河穿洞	丝娃娃,糯米饭,洋芋粑粑,旧州鸡辣子,安顺裹卷	夜郎文化,屯堡文化,穿洞文化
万宁	石梅湾,日月湾,兴隆热带植物园,大洲岛,神州半岛	和乐蟹,海南东山羊,槟榔,菠萝,后安粉	闽南语,闽语,2012海南万宁日月湾国际冲浪节,中国书法之乡,龙滚军坡
毕节	织金洞,百里杜鹃,乌江源百里画廊,草海,韭菜坪	黄粑,凉糕,酸菜,牛干巴,糍粑	火把节,彝族,跳花节,苗族,布依族
铜仁	印江土家族苗族自治县,石阡温泉群,梵净山,石阡,石阡温泉	米豆腐,绿豆粉,羊肉粉,炒粉,卷粉	土家族,苗族,仡佬族,紫薇花,侗族
厦门	鼓浪屿,厦门大学,环岛路,菽庄花园,南普陀寺	面线糊,肉粽,奶茶,佛跳墙,土笋冻	妈祖,南音,闽南语,高甲戏,歌仔戏
儋州	东坡书院,千年古盐田,石花水洞,松涛水库,云月湖	米烂	粤语,客家语,儋州话,临高话,客家话
乐东	天池,尖峰岭,黎母岭,西山岭,尖峰岭国家森林公园	红糖年糕,苗家三色饭,甜酸粉,芒果,香蕉	闽语,剪纸,花灯,黎族,崖州志
昌江	皇帝洞,霸王岭国家森林公园,斧头山,棋子湾,霸王岭自然保护区	野生蜂蜜,昌江芒果,白斩乳羊,清蒸鱼头,红椒酿肉	黎族,琼语,昌江县志,昌江赋,絣染
丽水	云和梯田,冒险岛水世界,沙溪古井,雪花漈,仙水洞	麻糍,清明果,缙云烧饼,缙云土面,松阳薄饼	龙蛋石,青田石,刘伯温传说,龙泉宝剑锻制技艺,丽水鼓词
东方	感恩学宫,俄贤岭,天南第一泉,鱼鳞洲风景区,鱼鳞洲	琼中山鸡,椰子船,红椒酿肉,琼山豆腐,东方白斩羔羊	海南话,黎语,黎族,哥隆人,海南黄花梨
九江	石钟山,庐山,三叠泉,白鹿洞书院,东林寺	酒糟鱼,庐山云雾茶,马头鱼,九江茶饼,湖口豆豉	采茶戏,赣剧,清音,文曲戏,九江高腔
绍兴	王羲之故居,大禹陵,南山湖,兰亭,沈园	酒酿圆子,臭豆腐,青团,小笼馒头,腊肠	越剧,吴语,莲花落,江南,乌篷船
衢州	三衢石林,仙霞关,古田山,廿八都,六春湖	清明粿,腊肠,麻糍,板栗,胡柚	吴语,烂柯人,开化纸,衢州三怪,衢州麻饼
镇江	,焦山,北固山,南山风景区,隆昌寺	锅盖面,镇江糖醋萝卜干,镇江醋,丹阳大麦粥,水晶肴肉	吴语,黄梅戏,扬剧,镇江话,西石城风俗志
宜春	明月山,阁皂山,三皇宫,萝卜潭,洞山	霉豆腐,三杯鸡,扎粉,冻米糖,高安腐竹	黄梅戏,采茶戏,宜春评话,上高道情,曹洞宗
金华	横店影视城,兰溪地下长河,双龙洞,艾青故居,吴晗故居	梅菜扣肉,肉圆,清明粿,金华酥饼,金华火腿	吴语,红木,婺剧,锡雕,磐安炼火
抚州	王安石纪念馆,高坊水库,陆九渊之墓,疏山寺,文昌桥	牛肉粉,抚州米粉,广昌白莲,龙兴铺灯芯糕,桂花鲜姜酱菜	赣语,傩舞,抚州话,道情,宜黄戏
吉安	武功山,桃花岛,井冈山风景区,井冈山,西阳宫	粉蒸肉,霉豆腐,炒粉,永新狗肉,安福火腿	莲花落,盾牌舞,傩舞,烧塔,永新三角班
黔西南	马岭河峡谷,双乳峰	羊肉粉,兴义羊肉粉,贞丰糯米饭,饵块粑	阿妹戚托
龙岩	承启楼,永定土楼,冠豸山,龙崆洞,长汀古城	客家菜,灯盏糕,地瓜粉,梅干菜,长汀豆腐干	客家语,闽南语,客家话,畲族,龙岩山歌
鹰潭	龟峰,上清宫,正一观,余江茄干,天师府	炒粉,清明果,灯芯糕,茄子干,贵溪捺菜	赣语,采茶戏,赣剧,道教文化,三角班
上饶	葛仙山,三清山风景名胜区,上饶灵山风景名胜区,怀玉山,上饶云碧峰国家森林公园	藜蒿炒腊肉,炒粉,清明果,铅山烫粉,薄荷炒螺蛳	吴语,鄱阳话,广丰话,弋阳腔,鹅湖书院
临高	百仞滩,居仁瀑布,临高角,高山岭,后水湾	菠萝蜜,沙虫,烤乳猪,香蕉,香茅	闽南语,闽语,临高启明,渔民节,临高语
景德镇	浮梁古城,洪岩仙境风景区,莲花塘,古窑,玉田水库	米粉,油条包麻子,炒米粉,冷粉,饺子粑	吴语,赣语,青花瓷,陶瓷,粉彩瓷
嘉兴	乌镇,南湖,南北湖,莫氏庄园,张乐平纪念馆	青团,粽子,杭白菊,南湖菱,海宁斜桥榨菜	越剧,吴语,沪剧,绍剧,湖剧
揭阳	文昌阁,风门古径,揭阳学宫,进贤门,揭阳音乐喷泉	肠粉,蚵仔煎,蚝烙,猪脚饭,无米粿	客家语,闽南语,闽语,客家山歌,潮汕
泰州	望海楼,光孝律寺,中国人民解放军海军诞生地纪念馆,夏道行,泰州市博物馆	蟹黄汤包,臭豆腐,红烧肉,肉脯,蟹黄包	吴语,江淮官话,泰州话,泰州学派,溱潼会船节
汕尾	莲花山,凤山妈祖石像,澎湃故居,红海湾,玄武山	皮皮虾,擂茶,菜茶,菜粿,发粿	客家语,妈祖,闽南语,闽语,客家话
宿迁	楚街,洪泽湖湿地自然保护区,中国杨树博物馆,宿迁极乐律院遗址,宿北大战纪念馆	煎饼,大煮干丝,朝牌,穿城大饼,五香大头菜	淮海戏,泗州戏,苏北大鼓,淮红剧,云渡桃雕
梅州	客家围屋,五华,中国客家博物馆,神光山国家森林公园,药王寺	白切鸡,酿豆腐,客家菜,盐焗鸡,腌面	客家语,客家文化,客家山歌,客家人,客家
潮州	开元寺,凤凰山,广济桥,潮州新八景,湘子桥	肠粉,牛肉丸,潮汕功夫茶,潮汕小吃,蚝烙	客家语,闽南语,闽语,潮学,潮汕民居
佛山	千灯湖,佛山祖庙,西樵山,清晖园,岭南天地	双皮奶,云吞面,粤菜,干蒸,糯米鸡	粤语,粤剧,岭南文化,佛山剪纸,行通济
徐州	放鹤亭,苏公塔影,徐州云龙湖风景区,彭祖园,云龙山	东坡回赠肉,徐州地锅鸡,徐州辣汤,徐州烙馍,鼋汁狗肉	刘裕,徐州方言,张道陵,徐州梆子,徐州琴书
连云港	花果山,抗日山,孔望山,连云港老街,海上云台山	煎饼,凉粉,朝牌,对虾,灌云豆丹	朱自清,江淮官话,淮海戏,徐福,僮子戏
河源	苏家围,镜花缘景区,万绿湖风景区,黄龙岩,御临门温泉	酿豆腐,客家菜,盐焗鸡,东江盐焗鸡,客家酿豆腐	粤语,客家语,客家文化,闽南语,闽语
黄山	黄山,齐云山,文峰塔,太平湖,永庆庵	黄桥烧饼,徽菜,徽墨酥,毛豆腐,徽州臭豆腐	吴语,徽语,徽州文化,徽派建筑,歙砚
中山	中山公园,孙中山故居纪念馆,孙文公园,孙中山纪念堂,利和广场	咸煎饼,三乡濑粉,脆肉鲩,神湾菠萝,杏仁饼	粤语,粤剧,小榄菊花会,崖口飘色,黄圃飘色
盐城	白天鹅公园,息心寺,郝柏村故居,江苏盐城国家级珍禽自然保护区,东台董永七仙女文化园	鸡蛋饼,猪头肉,建湖藕粉圆子,马家荡螃蟹,四鳃鲈鱼	江淮官话,淮剧,香火戏,金沙湖,东台发绣
清远	连州地下河,长湖,宝晶宫,广东第一峰旅游风景区,湟川三峡	白切鸡,艾糍,东陂水角,灰水粽,清新冰糖桔	粤语,客家语,中国温泉之乡,瑶族,壮族
池州	九华山,九华天池,升金湖,平天湖,杏花村	霉豆腐,梅干菜,毛豆腐,东至米饺,西山焦枣	吴语,黄梅戏,贵池傩戏,东至花灯,青阳腔
宣城	敬亭山,中国鳄鱼湖,广德太极洞,谢朓楼,皖南事变烈士陵园	板栗,毛豆腐,炒面,锅贴饺,宁国粑粑	吴语,黄梅戏,宣纸,跳五猖,徽语
肇庆	阅江楼,九龙湖,竹海大观,鼎湖山,螺壳山	白切鸡,裹蒸粽,砂糖桔,皇帝柑,沙糖橘	粤语,广府文化,客家语,岭南文化,端砚
江门	梁启超故居,东湖,上下川岛,台山上川岛,下川岛	濑粉,新会陈皮,古井烧鹅,杜阮凉瓜,金山火蒜	粤语,粤剧,四邑话,,
阳江	海陵岛,闸坡大角湾,月亮湾,凌霄岩,阳江珍珠湾	白切鸡,油角,烧鹅,牛腩粉,杏仁茶	开渔节,阳江方言,阳江风筝,阳春话,阳江风筝节
云浮	护国寺,国恩寺,九星岩,金水台温泉,藏佛坑	鱼腐,绉纱鱼腐,河口肠粉,南乳花生,沙糖桔	粤语,客家语,涯话,瑶族,闽南话
茂名	中国第一滩旅游度假区,大雾岭,天马山,放鸡岛,浮山岭	肠粉,清补凉,砂锅粉,龙眼,荔枝	白话,飘色,涯话,年例,黎话
韶关	梅关古道,广东丹霞山世界地质公园,珠玑巷,丹霞山,三影塔	煲仔饭,酿豆腐,三华李,酸笋,山坑螺	粤语,客家语,客家文化,粤北采茶戏,月姐歌
湛江	西湖公园,十贤祠,天宁禅寺,广州湾法国公使署旧址,中澳友谊花园	白切鸡,猪肠粉,湛江生蚝,粉皮,湛江海鲜	粤语,遂溪醒狮,年例,中国醒狮之乡,雷州话
滁州	琅琊山,醉翁亭,明皇陵,韭山洞,女山湖	淮王鱼,秦栏老鹅,全椒酥笏牌,雷官板鸭,女山湖大闸蟹	黄梅戏,扬剧,庐剧,泗州戏,凤阳花鼓
桂林	李宗仁,象鼻山公园,龙胜梯田,七星公园,芦笛岩	桂花糕,恭城油茶,啤酒鱼,桂林田螺,灵川狗肉	桂林民歌,杀猪佬,桂剧,彩调,广西大鼓
贺州	客家围屋,姑婆山国家森林公园,灵峰山,大桂山,滑水冲自然保护区	糍粑,龙眼,豆腐酿,莲藕,笋干	粤语,客家语,傣族,赛龙舟,壮语
铜陵	凤凰山,和悦洲,铜陵天井湖,铜陵凤凰山,葛仙洞	铜陵生姜,顺安酥糖,铜陵茶干,野雀舌,凤丹	吴语,徽剧,庐剧,泗州戏,铜陵牛歌
梧州	白云山,中山纪念堂,骑楼城,龙母庙,四恩寺	肠粉,冰泉豆浆,六堡茶,纸包鸡,梧州腊肠	粤语,粤剧,龙母文化,梧州龙母诞,梧州宝石节
来宾	百崖大峡谷,莫土司衙署,金秀大瑶山,五马拦江,八仙天池	肠粉,米粉,红糟酸,炒螺,酥肉地豆	粤语,客家语,西南官话,麼个话,壮语
淮南	八公山,焦岗湖,茅仙洞,上窑森林公园,峡山口	臭豆腐,馓子,淮南牛肉汤,淮王鱼,豆腐宴	花鼓灯,八公山紫金砚,中国豆腐文化节,淮南子,推剧
贵港	桂平西山风景名胜区,罗丛岩,金田起义地址,大藤峡,龙潭国家森林公园	螺蛳粉,豆腐角,芝麻糊,藕粉,绿豆粥	粤语,客家语,壮语,柳州话,贵港话
马鞍山	石臼湖,褒禅山,采石矶,雨山湖公园,濮塘风景区	茶干,当涂大肉面,石臼湖螃蟹,黄池酱菜,鸭血粉丝	越剧,吴语,黄梅戏,徽剧,庐剧
宿州	皇藏峪,,瑞云寺,九女坟,涉故台	烧饼,撒汤,地锅鸡,油酥馍,面皮	泗州戏,砀山酥梨,坠子戏,灵璧石,梅花篆字
防城港	北部湾海洋文化公园,白浪滩,仙人山公园,簕山古渔村,西湾旅游景区	煎堆,风吹饼,光坡鸡,鸡屎藤粑仔,沙虫瘦肉粥	粤语,客家语,涯话,防城港国际海上龙舟节,壮语
钦州	六峰山,三娘湾,刘永福故居,越州天湖,八寨沟	钦州猪脚粉,粉利,小董麻通,官垌鱼,海鸭蛋	粤语,客家语,钦州坭兴陶,烟墩大鼓,丝弦戏
芜湖	鸠兹广场,镜湖公园,天门山,赭山公园,王稼祥纪念园	蟹黄汤包,无为板鸭,茶干,虾子面,锅巴	吴语,宣纸,芜湖铁画,铁画,徽剧
玉林	云天宫,真武阁,鹿峰山,谢仙嶂,鬼门关	牛腩粉,生料粉,肉蛋,容县沙田柚,酸料	粤语,客家语,闽南语,玉林荔枝狗肉节,中国（玉林）中小企业商机博览会
株洲	炎帝陵,方特,神农公园,醴陵,炎帝广场	血鸭,醴陵小炒肉,醴陵炒粉,麻仁香酥鸭	客家语,赣语,湘语,瑶族
河池	仙人桥,水晶宫,金城江公园,韦拔群纪念馆,南丹温泉	板栗,榨粉,艾糍粑,巴马香猪,龙滩珍珠李	客家语,壮锦,西南官话,壮语,铜鼓文化
邵阳	洞口文昌塔,武冈云山,高洲温泉,白水洞风景名胜区,云山国家森林公园	米粉,南山牧场,宝庆猪血丸子,血浆鸭,豆干	赣语,湘语,祁剧,邵阳花鼓戏,宝庆竹刻
娄底	湄江国家地质公园,湄江风景区,曾国藩故居,梅山龙宫,紫鹊界梯田	三合汤,珠梅土鸡,新化三合汤,永丰辣酱,青树坪米粉	湘语,梅山文化,双峰话
蚌埠	龙子湖,龙子湖公园,卞和洞,望夫石,禹王宫	鸡蛋饼,葱油饼,粽子,湖沟烧饼,烧饼夹里脊	中原官话,泗州戏,花鼓戏,花鼓灯,淮北梆子戏
淮北	皇藏峪,相山公园,临涣古镇,相山,显通寺	烧饼,板面,面皮,烫面,牛筋面	徽剧,庐剧,淮北梆子戏,淮北花鼓戏,淮北琴书
崇左	德天瀑布,左江斜塔,崇左石林,友谊关,恩城国家级自然保护区	鱼丸,艾糍,指天椒,八角,苦丁茶	粤语,瑶族,土家族,苗族,壮族
永州	阳明山,舜帝陵,九嶷山,金洞漂流,千家峒	血鸭,三味辣椒,永州喝螺,永州血鸭,祁阳曲米鱼	湘语,祁剧,捕蛇者说,永州八记,祁阳小调
郴州	北湖公园,刘同,东江湖,桃源洞,莽山	剁椒鱼头,米豆腐,血鸭,鱼粉,东江鱼	湘语,西南官话,湘南土话,资兴说,赶分社
怀化	万佛山,受降纪念坊,龙津风雨桥,高椅古村,中国侗文化城	米豆腐,酸萝卜,靖州杨梅,杨梅酒,辰溪酸萝卜	湘语,西南官话,辰河高腔,共和国第一大将粟裕,通道转兵
百色	靖西县龙潭湿地公园,靖西通灵大峡谷,通灵大峡谷,古龙山峡谷漂流风景区,百色起义纪念公园	糍粑,芒果,五色糯米饭,竹筒饭,白毫茶	粤语,壮语,抛绣球,田东芒果节,天琴
文山	文笔塔,坝美,西华公园,普者黑	酸汤鱼,辣椒骨,酸汤,虫茶	西南官话,壮语,苗语,铜鼓舞
玉溪	哀牢山,抚仙湖,通海秀山,杞麓湖,红塔山	鳝鱼凉米线,新平腌菜,玉溪米线,油卤腐,芝麻片	2012·中国·玉溪米线文化节,玉溪米线文化节,云烟之乡,玉溪镇文化志,玉溪赋
湘西	凤凰古城,乌龙山,芙蓉镇,德夯,南方长城	糍粑,酸萝卜,湘西腊肉,湘西米粉,湘西酸萝卜	赶尸,乾州古城,里耶古城
昭通	大山包,望海公园,念湖,五尺道,昭通抚镇门广场	烧饵块,炸洋芋,小寨樱桃,昭通苹果,酸菜红豆汤	孟孝琚碑
神农架林区	老君山,神农顶,古犀牛洞,神农架滑雪场,官门山	板栗,泡菜,懒豆腐,鸡蛋荞麦饼,腊蹄子	
张家界	天门山,张家界国家森林公园,袁家界,天门山国家森林公园,天子山	团年菜,杜仲茶	哭嫁,茅古斯,桑植民歌
大理	蝴蝶泉,洱海,大理古城,崇圣寺三塔,崇圣寺	乳扇,饵丝,南涧跳菜,饵块,乳饼	白族
恩施	恩施大峡谷,龙鳞宫,恩施土司城,腾龙洞,梭布垭石林	豆皮,合渣,油香儿,社饭,包谷粑	摆手舞,哭嫁,西兰卡普,肉连响,毛古斯舞
楚雄	土林,文峰塔,乌蒙山,光禄古镇,德丰寺	豆瓣酱,藕粉,花椒,蜂蜜,虎掌菌	山茶花,火把节,彝族,插花节,龙华会
曲靖	花山湖,罗平油菜花,麒麟公园,大海草山,海峰湿地	烧饵块,炸洋芋,蒸饵丝,饵丝,宣威火腿	爨龙颜碑,爨文化,爨宝子碑,爨,麒麟仙子
德宏	独树成林,一寨两国,南甸宣抚司署,莫里瀑布,姐勒金塔	小粒咖啡,卷粉,撒撇,稀豆粉,饵丝	三角梅,泼水节,景颇族,汉藏语系,葫芦丝
红河	阿庐古洞,双龙桥,红河哈尼梯田,蒙自租界址,闻一多先生旧居	包浆豆腐,石屏豆腐,蒙自过桥米线,云南红	锡都,锡制工艺品,梯田文化,建水紫陶,阿细跳月
临沧	澜沧江,广允缅寺,漫湾百里长湖景区,五老山,沧源崖画	粑粑卷,红茶烧肉,佤族鸡肉烂饭,拉祜烤肉,牛撒撇	傣族,摸你黑,彝族,佤族,景颇族
普洱	墨江北回归线标志园,碧溪古镇,普阳八景,普益公园,忠爱桥	普洱茶,竹笋,米干,紫米,紫胶	火把节,傣族,瑶族,彝族,佤族
常德	桃花源国家森林公园,城头山古文化遗址,澧州古城,孤峰塔,夹山寺	鸭脖子,牛肉米粉,馄饨,北堤麻辣肉,毛豆	常德方言,跑胡子,武陵戏,澧水船工号子,澧州大鼓
十堰	观音洞,武当山,玄武门,龙潭河风景区,龙潭河	木耳,竹笋,三合汤,郧县酸浆面,杜仲	儿骗,十堰站,武当山站
保山	武侯祠,哀牢山,太保山,腾冲县,太保山公园	施甸三味,清凉磨锅茶,蒲缥甜大蒜,保山豆粉,	西南官话,泼水节,,窝罗节,花山节
随州	中华山,随州文化公园,大洪山风景区,炎帝故里,中国千年银杏谷	糍粑,随州春卷,平林鸡汤,厉山腐乳,应山滑肉	黄梅戏,楚剧,编钟,打锣鼓,随州花鼓戏
益阳	洞庭湖,天问台,魁星楼,竹海,德昌公园	银鱼,擂茶,安化黑茶,黑茶,朱砂盐蛋	茶马古道,油纸伞,益阳话,益阳花鼓戏,水竹凉席
怒江	青藏高原,怒江,丙中洛,三江并流,石门关	烤乳猪,漆油鸡,打茶,杵酒,猴头菌	傣族,瑶族,白族,傈僳族,普米族
潜江	曹禺公园,潜江森林公园	尝香思,锅奎,小龙虾	西南官话,潜江花鼓戏
鄂州	莲花山,龙蟠矶,天平山旅游区,华容镇,白雉山	武昌鱼	鄂州文化体育公园
阿里	冈仁波齐峰,扎达土林,纳木那尼峰,玛旁雍错,古格王朝遗址	酥油茶,青稞酒,糌粑,酥油	藏语,藏族
山南	黑颈鹤,昌珠寺,雍布拉康,藏王墓,雅砻风景名胜区	酥油茶,青稞酒,糌粑,甜茶,酥油	望果节,藏戏,门巴族,藏戏艺术,吉祥歌
昌都	岳庙,长毛岭养鹿场,来古冰川,然乌湖,强巴林寺	糌粑,雪莲,昌都醉梨,怒江裂腹鱼,藏族酥酪糕	藏语,酥油花灯节,藏族,萨噶达瓦节,古庆节
那曲	麦莫溶洞,当惹雍错,那曲双湖无人区,象雄王国遗址,那曲河	酥油茶,酥油,风干肉,干酪,藏酒	藏语,藏族,藏文,热巴舞,那曲赛马节
林芝	南迦巴瓦峰,墨脱公路,雅鲁藏布大峡谷,通麦天险,帕嘎寺	酥油茶,青稞酒,糌粑,酥油	藏语,藏族,门巴族,珞巴族
海西	德令哈,可鲁克湖,柏树山,青海都兰吐蕃墓群,塔里他里哈遗址	酥油,青稞,曲拉,酥油糌粑	香日德寺,鲁茫沟岩画
日喀则	扎什伦布寺,耗牛肉,桑耶寺,宗山抗英遗址,绒布寺	牦牛肉,奶茶,酥油茶,风干肉	望果节,藏历年,藏刀,藏戏,斯马卓
哈密	哈密回王陵,烽燧,兰州湾子古石屋遗址,天山风景区,拉甫却克古城	烤全羊,奶茶,烤包子,羊肉串,油酥馍	汉语,古尔邦节,回族,维吾尔族,维吾尔语
黄石	仙岛湖,东方山,黄石国家矿山公园,团城山公园,小雷山	黄石港饼,金牛千张皮,金柯辣椒,灵溪豆豉,太子豆腐	京剧,楚剧,石雕,阳新采茶戏,阳新布贴
果洛	白云寺,星宿海,阿尼玛卿,拉加寺,鄂陵湖	酸奶,酥油糌粑,羊杂碎汤,果洛牛肉干,黄蘑菇	藏族,阿尼玛卿雪山传说,果洛德昂洒智,唐卡,果洛卓舞
五家渠	一万泉景区,五家渠文化广场,青格达湖	烤全羊,馕,手抓饭,羊肉抓饭,龙须酥	土家族,蒙古族,回族,维吾尔族,哈萨克族
仙桃	甘露寺	沔阳三蒸,仙桃蒸三元	沔阳话,沔阳花鼓戏,沔阳皮影戏,沔阳渔鼓,湖北道情
石河子	将军山,周恩来总理纪念碑,游憩广场,新疆兵团军垦博物馆,巴音山庄	大盘鸡,烤肉,哈密瓜,无花果,羊肉抓饭	达瓦孜,回族,维吾尔族,哈萨克族,兰银官话
黄南	孟达天池,德乾旺姆,吾屯下寺,南宗尼姑寺,隆务寺	酥油茶,青稞酒,糌粑,酥油	藏语,藏族,热贡艺术
海南	日月山,卡约文化遗址,阿尼玛卿,倒淌河,伏俟城	牦牛肉,酸奶,手抓羊肉,酿皮,奶酪	藏语,古尔邦节,开斋节,藏族,兰银官话
阿勒泰	喀纳斯湖,草原石人,蝴蝶沟,布尔根河狸自然保护区,乌伦古湖	手抓饭,熏马肠,大盘鸡,手抓肉,罐罐面	古尔邦节,哈萨克族,毡房,喀纳斯湖水怪,毛毡
吐鲁番	红河谷,火焰山,葡萄沟,苏公塔,柏孜克里克千佛洞	拉条子,葡萄干,葡萄,哈密瓜,羊肉	丝绸之路,木卡姆
海东	孟达天池,公伯峡,翟昙寺,李家峡,互助北山	牦牛肉,酸奶,手抓羊肉,甜醅,西倾山	皮影戏,藏语,古尔邦节,藏族,兰银官话
昌吉	江布拉克,天山天池,昌吉古城,薄皮包子,大佛寺	手抓羊肉,丸子汤,新疆大盘鸡,椒麻鸡,米肠子	古尔邦节,回族,维吾尔族,哈萨克族,都瓦
漯河	沙澧河风景区,小商桥,三绝碑,许慎墓,彼岸寺碑	胡辣汤,烩面,凉粉,豆腐脑,水煎包	农民画,旱船,六合拳,船工号子,双狮舞
克拉玛依	魔鬼城,克拉玛依河,白杨河大峡谷,黑油山,艾里克湖	馕,烤包子,大盘鸡,马奶酒,凉皮子	穆斯林,伊斯兰教,古尔邦节,维吾尔族,肉孜节
迪庆	虎跳峡,普达措国家公园,纳帕海,飞来寺,白马雪山	火锅,糌粑,松茸,奶渣,藏香猪	纳西族,彝族,藏族,藏传佛教,白族
玉树	通天河,三江源自然保护区纪念碑,三江源自然保护区,五道梁站,文成公主庙	酥油茶,青稞酒,糌粑,烤羊肉,青稞	藏语,蒙古族,布依族,玉树赛马会,康巴人
海北	卡约文化遗址,仙米森林公园,黑河大峡谷,祁连山草原,西海郡	牛肉面,奶茶,酿皮,甜醅,尕面片	皮影戏,剪纸,刺绣,藏语,祭海
博尔塔拉	赛里木湖,草原石人,塞里木湖,哈日图热格风景区,怪石峪风景名胜区	烤全羊,馕,烤包子,羊肉串,抓饭	蒙古语,萨满教,蒙古族,维吾尔族,藏传佛教
塔城	鹿角湾,塔斯提风景区,巴克图口岸,乌苏温泉,蒙古庙草场	椒麻鸡,大盘鸡,风干肉,沙湾大盘鸡,纳仁	达斡尔族刺绣,维吾尔族,哈萨克族,达斡尔人,鲁日格勒舞
周口	太清宫,太昊陵,老君台,老子故里,明道宫	逍遥镇胡辣汤,逍遥胡辣汤,妈糊,太康肘子,酱黄花菜	淮阳荷花节,庙会,淮阳县泥泥狗,淮阳太昊陵人祖庙会,太康道情
平顶山	三苏园,三苏墓,中原大佛,尧山,叶县县衙	胡辣汤,锅盔,烩面,凉皮,饸饹面	豫剧,曲剧,马街书会,鹰城广场,叶公
鹤壁	云梦山,大伾山,浮丘山,古灵山,阿斗寨	胡辣汤,烩面,饸饹面,籽馍,淇河三珍	社火,泥咕咕,大平调,浚县石雕,黄河古陶
许昌	西湖公园,曹丞相府,春秋楼,文峰塔,紫云书院	胡辣汤,烩面,焖面,水煎包,热豆腐	豫剧,曲剧,越调,钧瓷,三国文化
商丘	商丘古城,应天府书院,火神台,木兰祠,燧人氏陵	水激馍,糖糕,薛湖牛肉水煎包,烧饼,羊肉烩面	三商文化,木兰传说,月下老人,钻木取火,梁园吟
日照	万平口,浮来山,日照海滨国家森林公园,文心广场,五莲山风景区	文蛤,锅饼,日照绿茶,莒县全羊汤,五莲樱桃	农民画,黑陶,文心雕龙,日照农民画,黑陶文化
济源	小浪底,五龙口,王屋山,大明寺,西滩景区	捞面条,鸡蛋不翻,土馍,麻糖,卤肉夹馍	豫剧,黄河号子,愚公移山,怀调,天坛砚
和田	安迪尔古城,尼雅遗址,阿克斯皮力古城,买力克阿瓦提,约特干遗址	馕,烤包子,羊肉串,和田玉枣,杂克尔	丝绸之路,和田玉,和田玉籽料,和田玉雕,和田丝绸
阿拉尔	胡杨林,阿拉尔市军垦博物馆,阿拉尔金草滩,三五九旅屯垦纪念馆,塔克拉玛干沙漠	烤全羊,烤羊肉串,拉条子,馕,新疆大盘鸡	古尔邦节,开斋节,维吾尔族,维吾尔语,中国·阿拉尔首届红枣文化节
图木舒克	唐王城,怪石沟,化石沟,西海湾风景旅游区,西海湾	拉面,馓子,油塔子,红枣,馕	旱船,维吾尔语,踩高跷,刀郎麦西来甫,刀郎木卡姆
菏泽	黄河大桥,蚩尤墓,秦王避暑洞,齐鲁会盟台,孙膑旅游城	胡辣汤,羊肉汤,糖糕,水煎包,手抓饼	豫剧,四平调,牡丹文化,伏羲,鲁锦
枣庄	龟山,东湖,台儿庄古城,铁道游击队纪念碑,台儿庄大战纪念馆	辣子鸡,煎饼,糁汤,煎饼卷大葱,枣庄菜煎饼	皮影戏,鲁南花鼓,滕县松枝鸟,伏里土陶,洛房泥玩具
济宁	张良墓,微山湖,孔府,孔林,曲阜孔庙	煎饼,煎饼果子,把子肉,糁汤,鲁菜	炎帝,黄帝,武松,山东梆子,吕剧
克孜勒苏柯尔克孜	坎儿井,,突厥石人,三仙洞,莫尔佛塔	馕,拉面,馓子,油塔子,撒子	汉藏语系,阿尔泰语系,印欧语系,玛纳斯,江格尔
喀什	帕米尔高原,莎车,喀什大巴扎,卡拉库里湖,莎车王墓	烤全羊,葡萄,红枣,羊肉,无花果	旱船,维吾尔族,维吾尔语,石头城,喀什老城
濮阳	仓颉陵,澶渊之盟,戚城文物保护区,将军渡,毛楼生态旅游区	胡辣汤,烩面,凉皮,壮馍,牛肉耗辣椒	四平调,东北庄杂技,清丰柳子戏,南乐目连戏,罗卷戏
阿克苏	库车清真大寺,克孜尔千佛洞,库木吐拉石窟,麦吾拉乃穆清真寺,昭怙厘大寺	馕,拉面,馓子,油塔子,红枣	龟兹文化,多浪文化,麦西来甫,热瓦普,卡伦琴
东营	山东黄河三角洲国家级自然保护区,黄河入海口,孙武祠,孙武湖,黄河水体纪念碑	文蛤,水煎包,虎头鸡,利津水煎包,黄河口大闸蟹	吕剧,舞龙,青州府花边,草编,陈官短穗花鼓
三门峡	函谷关,仰韶村遗址,三门峡站,鸿庆寺石窟,虢国墓地	凉粉,糖糕,灵宝大枣,大营麻花,观音堂牛肉	豫剧,秦腔,刺绣,社火,扬高戏
巴音郭楞	铁门关,博斯腾湖,巴音郭楞蒙古自治州博物馆,莲花湖,金沙滩	烤全羊,烤羊肉串,拉条子,馕,手抓饭	维吾尔族刺绣,楼兰文化,十二木卡姆,维吾尔族花毡、印花布织染技艺,麦西热甫
伊犁	赛里木湖,那拉提,果子沟,伊犁将军府,特克斯	拉条子,馕,面肺子,烤包子,大盘鸡	锡伯族
烟台	农博园,南山公园,栈桥,蓬莱阁,养马岛	鲅鱼饺子,葱烧海参,鲍鱼,焖子,莱阳梨	胶州秧歌,胶东大鼓,烟台话,亚洲沙滩运动会,海阳大秧歌
嘉峪关	嘉峪关,嘉峪关长城,嘉峪关关城,长城第一墩,悬臂长城	烤羊腿,烤羊肉,烧壳子,搓鱼面,手抓肉	秦腔,陇剧,霸王鞭,夜明珠,定城砖
天水	净土寺,麦积山,麦积山石窟,伏羲庙,甘谷大象山	凉粉,浆水面,打卤面,秦安蜜桃,面鱼	秦腔,伏羲文化,大地湾文化,浴佛节,天水秧歌
甘南	桑科草原,冶力关,拉卜楞寺,达宗湖,米拉日巴佛阁	青稞酒,奶渣,蕨麻,盖碗茶,砖茶	酥油茶,雪顿节,沐浴节,望果节,藏传佛教
白银	会师塔,会师楼,铁木山,法泉寺,白银人民广场	擀面皮,猫耳朵,大肉面,清汤羊肉,靖远羊羔肉	秦腔,秦剧,古琴,眉户戏,小调
定西	威远楼,仁寿山,通渭温泉,贵清山,遮阳山	浆水面,马铃薯,醪糟,洋芋搅团,陇西腊肉	秦腔,秦剧,通渭木雕,定西剪纸,洮砚
武威	文庙,白塔寺,鸠摩罗什寺,武威沙漠公园,天祝三峡国家森林公园	拉条子,酿皮,凉面,面皮,葡萄酒	煎饼,秦腔,凉州贤孝,秦剧,凉州民歌
陇南	万象洞,武都千坝草原,哈达铺红军长征纪念馆,鸡峰山,官鹅沟国家森林公园	锅盔,擀面皮,羊杂碎,洋芋搅团,羊肚菌	秦腔,花灯戏,陇剧,西和乞巧节,高山戏
廊坊	天下第一城,白塔寺,龙冢古墓,李少春纪念馆,齐圪垯汉墓	疙瘩汤,驴肉火烧,金丝小枣,香河肉饼,薛家窝头	京剧,北京琴书,河北梆子,评剧,冀鲁官话
庆阳	周祖陵,北石窟寺,陆武成,小崆峒山,南梁革命纪念馆	臊子面,肉夹馍,饸饹面,黄花菜,羊羔肉	秦腔,曲剧,陇剧,香包,黄帝内经
渭南	华山,处女泉,精进寺塔,桥陵,仓颉庙	臊子面,凉粉,荞面饸饹,凉皮,石子馍	秦腔,阿宫腔,碗碗腔,老腔,同州梆子
张掖	焉支山,山丹军马场,汉明长城,甘州古塔,马蹄寺	臊子面,凉粉,拉条子,大肉面,大盘鸡	秦腔,眉户,陇剧,旱船,霸王鞭
晋城	白马寺,青天河,净影寺,怀覃会馆,峰林峡	素氽汤,高平烧豆腐,泽州甜柿,阳城烧肝,烧大葱	泽州鼓书,泽州四弦书,晋城吴王庙,泽州秧歌,晋城剪纸
临夏	黄河三峡,刘家峡,炳灵寺石窟,太极湖,太极岛	锅盔,牛肉面,酿皮,黄河鲤鱼,炒面片	秦腔,陇剧,黄河号子,临夏彩绘,临夏花儿
临汾	黄河壶口瀑布,平阳鼓楼,尧庙,太岳山国家森林公园,荀子文化园	饸饹面,荞麦灌肠,擦圪蚪,油炸馓子,乡宁白面油糕	蒲剧,威风锣鼓,大槐树祭祖习俗,天塔狮舞,翼城花鼓
商洛	龟山,天竺山,牛背梁国家森林公园,商山四皓碑林园,凤冠山	锅盔,搅团,菠菜面,粽子,牛筋面	秦腔,商洛花鼓,洛南静板书,商洛道情戏,汉调二黄
酒泉	莫高窟,敦煌古城,月牙泉,阳关,敦煌雅丹国家地质公园	拉条子,油塔子,油酥馍,甜水面,瓜州蜜瓜	越剧,夜光杯雕,酒泉夜光杯,酒泉古代岩刻画,东晋壁画
平凉	崆峒山,云崖寺,荆山,王母宫,龙泉寺	臊子面,羊肉泡馍,凉粉,擀面皮,搅团	秦腔,陇剧,纸织画,马社火,陇东皮影
铜川	香山,药王山,福地湖,玉华宫,大香山寺	锅盔,糖糕,油茶,饸饹,米糕	豫剧,秦腔,眉户,碗碗腔,耀州窑
金昌	钟鼓楼,金水湖,北海子公园,金川公园,骊靬遗址	手抓羊肉,黄焖羊肉,羊肉垫卷子,粉汤,双湾西瓜	秦腔,眉户,陇剧,永昌县卍字灯俗,民勤小曲
咸阳	汉阳陵,乾陵,咸阳湖,杨贵妃墓,咸阳宫	锅盔,biangbiang面,肉夹馍,豆腐脑,搅团	秦腔,汉调桄桄,眉户,阿宫腔,弦板腔
衡水	河北衡水湖国家级自然保护区,宝云塔,周窝音乐小镇,周亚夫墓,景县舍利塔	深州蜜桃,黄韭,衡水老白干,饶阳豆腐脑,武邑扣碗	河北梆子,深州黑陶,鼻烟壶,武强年画,衡水内画
吕梁	北武当山,玄中寺,碛口古镇,碛口,卦山	莜面,凉皮,油炸糕,洋芋擦擦,面皮	晋剧,晋语,秧歌,碗碗腔,柳林盘子
榆林	白云山,红碱淖,榆林卫城,李自成行宫,易马城遗址	手抓羊肉,油旋,凉皮,马蹄酥,洋芋擦擦	陕北窑洞,陕北说书,陕北秧歌,陕北民歌,定边剪纸艺术
长治	南涅水石刻馆,太行龙洞,八路军文化园,天脊山,八路军太行纪念馆	甩饼,沁州黄小米,长治黑圪条,长治烩面,上党糊肘子	襄垣鼓书,黎侯虎,上党落子,上党八音会,上党堆锦
朔州	西山公园,释迦塔,朔州市紫金山自然保护区,大安寺,崇福寺	羊杂割,油糕,怀仁糖干炉,揪片,莜面栲栳	垒旺火,北路梆子,广武汉墓群,骡驮轿,朔州秧歌戏
忻州	情人谷,老牛湾,五台山,雁门关,忻州北城门楼	焖面,羊杂碎,过油肉,神池月饼,忻州瓦酥	二人台,神池道情,五台山佛乐,定襄面塑,挠羊赛
固原	六盘山,须弥山石窟,火石寨,,老龙潭	凉皮,麻食,马铃薯,土豆,须弥山	秦腔,花儿,回族音乐,回族服饰,方棋
晋中	镇国寺,张壁古堡,绵山,双林寺,乔家大院	猫耳朵,刀削面,贯馅糖,壶瓶枣,平遥碗托	晋剧,晋语,花灯,踩高跷,太谷秧歌
乌兰察布	辉腾锡勒草原,集宁战役纪念馆,黄花沟旅游区,苏木山,岱海	莜面,饸饹,奶豆腐,卓资山熏鸡,莜面鱼鱼	呼麦,安代舞蹈,敖包节,东路二人台,察哈尔婚礼
包头	希拉穆仁草原,包头南海湿地景区,五当召,北方兵器城,成吉思汗草原生态园	莜面,稍美,焙子,奶酪,手扒肉	二人台,呼麦,包头话,漫瀚剧,脑阁
吴忠	一百零八塔,同心清真大寺,青铜峡旅游区,牛首山寺庙群,中华黄河坛	手抓羊肉,酿皮,羊杂碎,油香,馓子	秦腔,回族音乐,回族服饰,回族医药,宁夏回族民间武术
鄂尔多斯	成吉思汗陵,成吉思汗广场,郡王府,响沙湾,响沙湾旅游景区	烤全羊,酿皮,莜面,焖面,伊金霍洛旗	晋语,那达慕,蒙古族,鄂尔多斯婚礼,蒙族舞
中卫	沙坡头,中卫岩画,天都山石窟,海原清真大寺,石空寺石窟	马铃薯,硒砂瓜,中宁枸杞,清蒸鸽子鱼,中宁蒿子面	秦腔,回族音乐,回族服饰,回族民歌,舞龙
石嘴山	贺兰山岩画,韭菜沟,星海湖,北武当庙,马兰花大草原	手抓羊肉,凉皮,油香,羊羔肉,枸杞	秦腔,查拳,回族民歌,回族民间器乐,回回十八肘
乌海	乌兰布和沙漠,乌海市植物园,甘德尔山,乌海科技馆,金沙湾生态旅游区	荞面饸饹,酿皮,混糖月饼,清汤牛尾,土豆粉	二人台,晋剧,晋语,漫瀚剧,翻子拳
呼伦贝尔	呼伦贝尔草原,牙克石凤冠滑雪场,满洲里国门,海拉尔要塞,嘎仙洞	烤全羊,奶茶,手把肉,羊肉串,手扒肉	马头琴,那达慕,呼麦,萨满,四胡
葫芦岛	兴城古城,碣石宫,葫芦山庄,觉华岛,兴城温泉	干豆腐,虹螺岘干豆腐,雷家店薄皮核桃,杏仁米粥,六股河鸭蛋	长锦小片,朝鲜族,布依族,侗族,古筝
兴安盟	科尔沁草原,阿尔山温泉,察尔森水库,图牧吉国家级自然保护区,乌兰夫办公旧址	锅包肉,烤全羊,冻柿子,羊杂碎,朝鲜冷面	二人转,马头琴,那达慕,东北大秧歌,
阳泉	藏山,狮脑山,百团大战纪念碑,娘子关瀑布,娘子关	焖面,过油肉,不烂子,莜面栲栳栳,平定黄瓜干	豫剧,二人台,晋剧,襄垣鼓书,阳泉评说
通辽	锅包肉,通辽机场,大青沟,珠日河牧场,珠日河草原	杀猪菜,烤冷面,荞面,西辽河,风干牛肉干	马头琴,安代舞蹈,科尔沁蒙古剧,乌力格尔,好来宝
锡林郭勒盟	贝子庙,多伦诺尔,锡林郭勒草原,乌珠穆沁草原,山西会馆	烤全羊,莜面,手把肉,拔丝奶豆腐,奶豆腐	马头琴,那达慕,呼麦,四胡,胡尔沁说书
阿拉善盟	额济纳胡杨林,哈布茨盖怪石林,贺兰山国家狩猎场,敖伦布拉格大峡谷,延福寺	糌粑,奶皮子,奶酪条,奶酒,炒米	牛羊肉烹制技艺,沙力搏尔式摔跤,查玛内,阿拉善左旗地毯,蒙古族养驼习俗
朝阳	凤凰山,朝阳南塔,朝阳双塔,清风岭,朝阳北塔	粘豆包,大酱,东北大拉皮,荆花蜜,干白菜	二人转,刺绣,评剧,佛教,三燕文化
巴彦淖尔	乌兰布和沙漠,乌梁素海,乌拉特草原,镜湖,纳林湖	酿皮,焖面,华莱士瓜,河套蜜瓜,河套硬四盘	蒙古语,二人台,晋语,蒙古族,蒙古舞
鞍山	二一九公园,汤岗子温泉,千山风景区,玉佛苑,千山玉佛苑	锅包肉,南果梨,东北大拉皮,牛庄馅饼,鞍山肉枣	二人转,东北官话,伊斯兰教,高跷,道教
锦州	海棠山,锦州世博园,笔架山风景区,闾山,锦州笔架山	干豆腐,烀饼,锦州烧烤,沟帮子熏鸡,锦州小菜	东北官话,长锦小片,医巫闾山满族剪纸,锦州皮影戏,辽西高跷
白山	青山湖,长白山天池,长白山景区,长白山国际度假区,望天鹅	锅包肉,朝鲜冷面,猪肉炖粉条,打糕,地三鲜	东北官话,朝鲜族,满族文化,白山赋,白山黑水
通化	龙泉寺,玉皇山,三角龙湾,五女峰国家森林公园,杨靖宇烈士陵园	锅包肉,冷面,榛蘑,葡萄酒,通化葡萄酒	东北官话,朝鲜族,满语,通化赋,新石器时代遗址
丹东	月亮岛,凤凰山,大鹿岛,丹东溥仪东行宫,鸭绿江断桥	朝鲜冷面,白肉血肠,冷面,酸汤子,焖子	胶辽官话,单鼓,上打家什高跷,八河川皮影戏,满族荷包
延边	长白山景区,六顶山,防川,正觉寺,满天星风景区	锅包肉,朝鲜冷面,烧烤,打糕,粘豆包	二人转,朝鲜族,高丽,象帽舞,长鼓舞
吉林	凤凰山,长白山天池,北山公园,松花湖,世纪广场	锅包肉,杀猪菜,猪肉炖粉条,松花蛋,吉菜	文庙,朝鲜族,摇橹人,吉林国际雾凇冰雪节,吉林市歌舞团
本溪	本溪湖,五女山,观音阁,铁刹山,本溪国家地质公园	锅包肉,羊肉汤,板栗,山野菜,烤豆腐皮	东北官话,满语,中国枫叶之都,乞粒舞,本溪话
营口	营口辽河老街,辽河公园,楞严禅寺,仙人岛,营口西炮台	烧烤,烤牛肉,鲅鱼,玻璃牛,营口大酱	庙会,佛教,胶辽官话,基督教,营口话
四平	叶赫古城,四平战役纪念馆,偏脸城遗址,英雄城,二龙湖	熏肉大饼,玉米,李连贵大饼,熏兔,李连贵熏肉大饼	朝鲜族,东北大秧歌,满族,四平青年,东方马德里
抚顺	清永陵,赫图阿拉城,元帅林国家森林公园,三块石国家森林公园,西露天矿	锅包肉,杀猪菜,朝鲜冷面,疙瘩汤,麻辣拌	满族,东北大鼓,满族剪纸,煤雕,走马灯
盘锦	红海滩,辽河美术馆,辽河碑林,盘锦湖滨公园,双台河口国家级自然保护区	锅包肉,文蛤,皮皮虾,烤冷面,蛤蜊	东北官话,辽河,兴隆大家庭,鹤望兰花,槐
牡丹江	东北虎林园,莲花湖,镜泊湖国家级风景名胜区,镜泊湖,双峰林场	杀猪菜,煎饼合子,烤冷面,松菌,响水大米	二人转,评剧,萨满祭祀,东北大鼓,满族服饰
天门	陆羽纪念馆,西塔寺,陆羽故园,陆羽亭,石家河遗址群	蒸菜,天门锅盔,张港火烧粑,天门三蒸,天门蒸菜	,天门花鼓戏,天门皮影戏,天门话,石家河文化
鸡西	珍宝岛,兴凯湖,黑龙江东方红湿地国家级自然保护区,城子河区,黑龙江兴凯湖国家级自然保护区	杀猪菜,烤冷面,酸菜,冷面,榛蘑	二人转,,东北秧歌,新开流文化,地窖
辽源	龙首山,寒葱顶国家森林公园,福寿宫,辽源国家矿山公园,辽源杨木水库	猪肉炖粉条,地三鲜,榛蘑,地皮菜,松伞蘑	二人转,农民画,满族,东北文化,琵琶
白城	吉林莫莫格国家级自然保护区,莫莫格,嫩江湾国家湿地公园,吉林向海国家级自然保护区,鹤舞向海	锅包肉,杀猪菜,猪肉炖粉条,松花蛋,玉米	二人转,东北官话,朝鲜族,满族,蒙古族
铁岭	龙首山,莲花湖国家湿地公园,银冈书院,清河省级旅游度假区,清河水库	羊肉汤,榛蘑,牛肉火勺,榛子,烤烟	二人转,东北官话,满族,满语,刘老根
松原	龙华寺,吉林查干湖国家级自然保护区,狼牙坝,长山明珠园,哈达山	锅包肉,酸菜,豆包,铁锅炖鱼,鳙鱼	东北官话,肃慎,满族,查干湖冬捕,满族新城戏
七台河	七台河市革命烈士陵园,西大圈森林公园,西大圈旅游区,桃山公园,吉兴河水库	锅包肉,冻柿子,杀猪菜,猪肉炖粉条,地三鲜	忽悠,冬泳,旮旯,手闷子,七台河山湖艺术节
双鸭山	七星峰,珍宝岛,安邦河国家湿地公园,青山国家森林公园,雁窝岛城址	鹿茸,木耳,蘑菇,松子,猴头	二人转,东北官话,俄罗斯工艺品,东北大秧歌,普通话
鹤岗	小兴安岭原始森林公园,名山岛,中俄黑龙江三峡,白龙潭,俄罗斯风情园	鹿茸,木耳,蘑菇,松子,猴头	二人转,东北官话,俄罗斯工艺品,东北大秧歌,哈喇子
辽阳	太子河,白塔,石洞沟森林公园,文庙,东京陵	南果梨,塔糖,山楂,香水梨干,老世泰上杂糕	二人转,东北官话,汉语,满族,满语
伊春	水上公园,汤旺河石林风景区,红星湿地国家级自然保护区,乌伊岭国家级自然保护区,新青白头鹤国家级自然保护区	人参,鹿茸,榛子,炖山珍,黄花菜蘑菇汤	朝鲜族,满族,蒙古族,回族,宁古塔
保定	千佛山,清苑县东闾教堂,东闾中华圣母堂,白洋淀,直隶总督署	豆腐脑,驴肉火烧,板面,火烧,直隶官府菜	哈哈腔,保定三宝,野火春风斗古城,曲阳石雕,定州秧歌
大兴安岭	北极村,雪乡,铁道兵开发大兴安岭纪念碑,呼中自然保护区,李金镛祠堂	锅包肉,冻柿子,杀猪菜,东北炖菜,小鸡炖蘑菇	蒙古族,鲜卑,鄂伦春族,鄂温克人,东北方言
黑河	五大连池风景区,胜山要塞,大黑河岛,火烧山,爱辉历史陈列馆	苏波汤,木耳,猴头菇,蓝莓,蕨菜	鄂伦春,满族,蒙古族,回族,亲亲的黑河
北海	东坡亭,银滩,冠头岭,北海涠洲岛,北海海底世界	沙蟹汁	北海足球
德州	德州新湖,黄河故道森林公园,红坛寺森林公园,减河湿地公园,德州新湖风景区	老豆腐,吊炉烧饼,金丝小枣,德州扒鸡,西瓜	德州黑陶,武城架鼓,八极拳,武城运河船工号子,马堤吹腔
萍乡	武功山,孽龙洞,安源路矿工人运动纪念馆,仰山文塔,鹅湖公园	剁椒鱼头,霉豆腐,炒粉,艾米果,莲花血鸭	赣语,莲花落,采茶戏,毛主席去安源,赣剧
亳州	万佛塔,天静宫,花戏楼,薛阁塔,曹操运兵道	锅贴,格拉条,干扣面,牛肉馍,蒙城油酥烧饼	豫剧,泗州戏,道教,淮北梆子戏,五禽戏
大同	云冈石窟,悬空寺,恒山,善化寺,慈云寺	大同刀削面,油炸糕,浑源凉粉,阳高杏脯,大同羊杂	二人台,晋剧,广灵剪纸,大同话,大同铜器
宁德	白水洋,福鼎俞山岛,福安,翠屏湖,霞浦	肉燕,牛肉丸,光饼,鼎边糊,对虾	闽剧,畲族,畲族民歌,柘荣布袋戏,四平戏
黔东南	肇兴侗寨,岜沙苗寨,云台山,西江千户苗寨,镇远古镇	酸汤鱼,米粉,锅巴粉,牛瘪,麻江县	侗族大歌,苗年,芦笙节,苗族姊妹节
荆州	关帝庙,金凤广场,荆州古城,文星楼,蓝田生态旅游风景区	热干面,三鲜豆皮,油焖大虾,豆皮,珍珠丸子	楚文化,花牌,马山民歌,荆州花鼓戏
南平	武夷山,万木林,宝山,五凤楼,天成奇峡	鼠曲粿,武夷岩茶,建瓯光饼,浦城豆腐丸,酸枣糕	越剧,吴语,闽语,建瓯挑幡,游春戏
漳州	南靖土楼,漳州滨海火山国家地质公园,云水谣,东山岛,赵家堡	荔枝肉,沙茶面,姜母鸭,润饼,四果汤	客家语,妈祖,南音,闽南语,歌仔戏
三明	桃源洞,将乐玉华洞,麒麟山,鳞隐石林,三明格氏栲国家森林公园	青云山,粿条,糍粑,扁肉,武夷山	客家语,闽语,客家人,客家,客家祖地
扬州	文游台,神居山,盂城驿,净土寺塔,清水潭旅游度假区	高邮双黄鸭蛋,秦邮董糖,界首茶干,蒲包肉,高邮酱油面	龙虬文化,高邮民歌,扬剧,2013中国扬州鉴真国际半程马拉松赛,扬州话
黄冈	东坡赤壁,遗爱湖,天堂寨,李时珍陵园,红安烈士陵园	板栗烧鸡,粽子,鱼糕,藕粉,巴河莲藕	黄梅戏,文曲戏,黄梅挑花,活字印刷术,黄冈竹楼记
运城	关帝庙,五老峰,永乐宫,秋风楼,莺莺塔	羊肉泡馍,凉皮,扯面,油泼面,刀削面	眉户,蒲剧,西厢记,舜耕历山,黄帝战蚩尤
张家口	坝上草原,大境门,中华三祖堂,官厅水库,清远楼	莜面,驴肉火烧,口蘑,柴沟堡熏肉,菜焙子	二人台,晋语,打树花,黄帝城,三祖文化
驻马店	中原官话,嵖岈山,宿鸭湖,宝严寺塔,薄山湖	豆腐脑,麻辣烫,馓子,烙馍,麻叶子	豫剧,曲剧,重阳节,梁祝故里,蔡姓
遵义	娄山关,遵义会议会址,赤水大瀑布,红军山,金鼎山	丝娃娃,黄粑,肠旺面,豆腐圆子,羊肉粉	地戏,仡佬族,茅台,傩文化,沙滩文化
唐山	南湖公园,清东陵,唐山抗震纪念碑,李大钊故居纪念馆,唐山南湖公园	缸炉烧饼,花生酥糖,蜂蜜麻糖,迁西板栗,棋子烧饼	评剧,唐山话,唐山皮影,乐亭大鼓,唐剧
六安	八公山,万佛山,大别山,万佛湖,张店中学	狮子头,六安臭干子,霍山黄芽,寿县牛肉汤,蒿子粑粑	黄梅戏,庐剧,舒城贡席,寿春楚文化,皋陶文化
滨州	孙子兵法城,魏氏庄园,碣石山,杜受田故居,秦皇台	水煎包,锅子饼,芝麻酥糖,大山烧鸡,咸鸭蛋	莲花落,山东梆子,吕剧,滨州老粗布,滨州剪纸
新余	仙女湖,抱石公园,竹叶青茶,孔目江国家湿地公园,仰天岗森林公园	辣椒炒肉,炒粉,扎粉,新余蜜桔,螺蛳	赣语,花鼓戏,采茶戏,新余话,天工开物
内江	隆昌石牌坊,高峰寺,内江大自然温泉,静宁寺,重龙山	内江牛肉面,黄老五花生酥,大千干烧鱼,大千鸡块,极品溢香鸡	文庙,牛灯舞,盘破门,资中武庙
眉山	三苏祠,东坡湖公园,中岩寺,黑龙滩,眉山黑龙滩风景区	东坡肘子,东坡鱼,东坡松花蛋,干巴牛肉,甜皮鸭	东坡国际文化节,道教文化,青神竹编
新乡	跑马岭,关帝庙,八里沟,比干庙,万仙山景区	胡辣汤,烩面,串串香,凉粉,焖面	豫剧,曲剧,二夹弦,汲冢书,马皮舞
宜宾	老君山,云台山,蜀南竹海,竹海,兴文石海	黄粑,燃面,宜宾燃面,猪儿粑,五粮液	大观楼,酒都,李庄,万里长江第一城,南丝绸之路
泸州	法王寺,报恩塔,画稿溪,龙脑桥,黄荆老林	黄粑,猪儿粑,豆花,合江荔枝,古蔺麻辣鸡	川剧,油纸伞,四川清音,泸州老窖,长江石
乐山	东坡楼,峨眉山,乐山大佛,凌云山,乐山睡佛	跷脚牛肉,甜皮鸭,狼牙土豆,罗城古镇,泉水鱼	乐山竹园烈士纪念园,朱氏节孝坊,熊克武故居,雷畅故居
攀枝花	大黑山森林公园,望月楼,红格温泉,攀枝花公园,海塔风景区	盐边牛肉,芒果,油底肉,羊肉米线,鱼头火锅	京剧,川剧,苴却砚,约德节,打跳
安阳	珍珠泉,文峰塔,殷墟,中国文字博物馆,殷墟博物馆	烩面,皮渣,扁粉菜,道口烧鸡,老庙牛肉	邺城,甲骨文,周易,殷商文化,中国航空运动之都
雅安	喇叭河,青衣江,碧峰峡,二郎山,蒙顶山	燃面,甜水面,砂锅雅鱼,蒙顶茶,边茶	川剧,抬阁,荥经砂器,七里夺标民俗节,绿林派
湘潭	糖油粑粑,和平公园,仙女山,水府庙,毛泽东同志故居	臭豆腐,冰糖湘莲,油粑粑,灯芯糕,湘潭槟榔	湘剧,皮影戏,湘语,花鼓戏,巫家拳
凉山	关门山,观海湾,螺髻山仙人洞,邛海,彝海	酥油茶,手抓羊排,南涧跳菜,百味荞饼,苏里玛酒	彝族火把节,西昌大通门,昭觉好谷东汉石表,青龙寺
自贡	仙市古镇,桫椤谷,恐龙灯会,三多寨,青山岭森林公园	水煮牛肉,富顺豆花,牛佛烘肘,冷吃兔,盐帮菜	自贡灯会,盐业历史博物馆,自贡话,西秦会馆,竹丝扇
遂宁	广德寺,灵泉寺,中国死海,高峰山,赤城湖	串串香,凉粉,凉面,豆腐干,豆腐皮	卓筒井
巴中	诺水河,章怀寺,佛头山森林公园,镇龙山国家森林公园,诺水河国家级风景名胜区	香菇炖腊肉,长赤翡翠米	巴中皮影,光雾山红叶节
资阳	安岳石刻,陈毅纪念馆,简阳三岔湖,字库山,王褒墓	担担面,简阳羊肉汤	麻将,三贤故里
广安	翠湖,顾县古镇,金城山森林公园,象鼻河,越江河瀑布	凉虾,岳池米粉,西板豆豉,麻辣牛肉,中和豆花	岳池农家,岳池灯戏,云童舞,广安麻将,双枪老太婆
广元	牛头山,剑门蜀道,唐家河,千佛崖摩崖造像,柏林湖湿地公园	广元凉面,苍溪雪梨,女皇蒸凉面,广元酸菜,蒸凉面	广元女儿节,白花石刻,苍溪梨文化博览园,苍溪县红军渡景区,麻柳刺绣
达州	五峰山国家森林公园,仙女山,净土寺,清河古镇,莲花湖	米豆腐,凉虾,燃面,灯影牛肉,东柳醪糟	大竹竹唢呐,巴人故里,麻将,石桥火龙,元九登高节
甘孜	泸定桥,甘孜寺,塔公寺,白利寺,长青春科尔寺	金丝毛,团结包子,水淘糌粑,康定凉粉,花馍馍	满金寺,协庆寺,竹庆寺,汤东杰布,灵雀寺
阿坝	九寨沟国家级自然保护区,四川九寨沟风景名胜区,卧龙国家级自然保护区,五彩池,三奥雪山	咂酒,阿坝苹果,金川雪梨,阿坝蜜蜂,卡子核桃	各莫寺,扎崇节,赏花节,藏巴拉节,雪梨节
临沂	王羲之故居,沂蒙山,沂河,临沂市图书馆,云蒙湖	糁汤,煎饼卷大葱,锅饼,临沂糁,马头烤牌	郯城木版年画,孙膑兵法,临沂模式,郯城挂门笺,临沭柳编
沧州	文庙,清真寺,清风楼,人民公园,白洋淀景区	宫面,驴肉火烧,金丝小枣,沧州火锅鸡,火锅鸡	河北梆子,武术之乡,泊头火柴,沧州武术,镖不喊沧州
南通	濠河风景区,濠河,狼山,沈星,南通海底世界	刀鱼,麻饼,文蛤,西亭脆饼,醉泥螺	僮子戏,海安花鼓,沈绣,南通话,蓝印花布
衡阳	衡山,石鼓书院,南岳大庙,蔡伦纪念园,印山	糯米鸡,黄花菜,酥薄月饼,衡东土菜,耒阳粉皮	湘剧,黄梅戏,花鼓戏,祁剧,衡山影子戏
焦作	青天河,云台山,净影寺,焦作影视城,神农山	松花蛋,烙馍,武陟油茶,闹汤驴肉,许良扯面	怀川话,四大怀药,陈氏太极拳,月山八极拳,怀梆
德阳	文庙,三星堆博物馆,白马关,蓥华山,云湖国家森林公园	松花蛋,甜水面,中江挂面,什邡板鸭,罗江豆鸡	川剧,绵竹年画,德阳灯会,四川皮影,德阳潮扇
秦皇岛	南戴河国际娱乐中心,山海关,昌黎黄金海岸,鸽子窝公园,老龙头	煎饼合子,四条包子,晓晓炸排骨,烤大虾,长城饽椤饼	东北官话,昌黎地秧歌,抚宁吹歌,长锦小片
宜昌	长江三峡,昭君故里,三峡大瀑布,三峡人家风景区,清江画廊风景区	凉虾,红油小面,霉豆腐,榨广椒,萝卜饺子	中国长江三峡国际旅游节,屈家岭文化遗址,巴文化,屈原故里端午习俗,楚文化
淮安	京杭大运河,洪泽湖,周恩来故居,明祖陵,河下古镇	狮子头,淮扬菜,活珠子,大煮干丝,平桥豆腐	淮海戏,淮剧,楚汉文化,运河文化,青莲岗文化
安康	太极城,瀛湖,南宫山,鬼谷岭国家森林公园,燕翔洞	蒸面,浆水面,麻辣烫,炕炕馍,酸菜面	汉剧,汉阴油菜花节,汉水文化,紫阳民歌,安康龙舟赛
合川	钓鱼城,合川钓鱼城,石照县衙,王坚记功碑,云门山	合川桃片,合川肉片,合川桃片烧白,合川鱼片	巴文化,马门溪龙,宋蒙钓鱼城之战
聊城	山陕会馆,景阳冈,曹植墓,江北水城,东昌湖	油泼鸡,沙镇呱嗒,东阿阿胶,八批果子,冠县鸭梨	查拳,聊城杂技,中国运河文化博物馆,茌平剪纸,聊城雕刻葫芦
汕头	中山公园,南澳岛旅游区,汕头北回归线标志塔,汕头海湾大桥,汕头市小公园	肠粉,糖葱薄饼,牛肉丸,蚝烙,汕头粿条汤	潮汕功夫茶,潮汕小吃,汕头图书馆,潮汕赋,潮菜
南充	阆中古城,凌云山,西山,升钟湖,朱德故居纪念馆	川北凉粉,米粉,顺庆羊肉粉,张飞牛肉,南充冬菜	丝绸,川剧,四川话,三国文化节,四川清音
绵阳	圣水寺,窦圌山,富乐山,越王楼,七曲山大庙	绵阳米粉,廖排骨,梓潼片粉,梓潼酥饼,镶碗	川剧,四川麻将,九斗碗,羌族祭山会,四川清音
莱芜	莱芜战役纪念馆,雪野旅游区,雪野湖,云台山,莱芜九龙大峡谷	煎饼,豆腐箱,热豆腐,莱芜炒鸡,口镇方火烧	长勺之战,莱芜梆子,莱芜战役,中国国际航空体育节,莱芜锡雕
荆门	纪山寺,屈家岭文化遗址,纪山,明显陵,楚国古墓群	五香豆腐干,钟祥米茶,盘龙菜,长湖鱼糕,纪山龙米	荆门油菜花旅游节,钟祥长寿文化旅游节,阳春白雪,下里巴人,朱厚熜
台州	净土寺塔,天台山,天湖景区,济公故居,琼台仙谷	青团,咸饭,麦油脂,糟羹,麦虾	越剧,吴语,临海词调,抬阁,大田板龙
南阳	南阳府衙,武侯祠,内乡县衙,医圣祠,商圣苑	胡辣汤,锅盔,赊店老酒,西峡香菇酱,仲景香菇酱	南阳烙画,中国南阳张仲景医药科技文化节,玉雕,黄石砚,新野猴戏
咸宁	九宫山,富水湖,山湖温泉,崇阳县图书馆,咸宁温泉	热干面,通山包坨,肉糕,宝塔肉,甑蒸糕	提琴戏,崇阳花鼓戏,湖北高腔,赤壁脚盆鼓,通山山歌
安庆	天柱山,振风塔,小孤山,菱湖风景区,迎江寺	胡玉美蚕豆辣酱,墨子酥,江毛水饺,岳西茯苓,天柱剑毫	黄梅戏,徽剧,四大徽班,桐城文派,皖派
惠州	惠州西湖,罗浮山,合江楼,惠东港口海龟国家级自然保护区,平海古城	梅菜扣肉,酿豆腐,横沥汤粉,客家菜,龙门米粉	四东文化,客家语,惠东渔歌,龙形拳,客家文化
柳州	文庙,龙潭公园,柳侯公园,三江鼓楼,柳侯祠	白切鸡,螺蛳粉,马蹄糕,粉饺,云片糕	客家语,柳州山歌,侗族大歌,侗族木构建筑营造技艺,侗戏
舟山	普陀山风景名胜区,桃花岛,情人岛景区,嵊泗列岛风景名胜区,三星国际灯塔	酒酿圆子,青团,虾干,大烤目鱼,黄鱼鲞	吴语,观音传说,舟山贝雕,舟山走书,潮魂
赤峰	克什克腾大草原,大明塔,喀喇沁亲王府,喀喇沁旗美林谷滑雪场,乌兰布统古战场	锅包肉,荞面饸饹,锅贴,手把肉,赤峰对夹	红山文化,巴林石
万州	潭獐峡,太白岩,青龙瀑布,万州海洋馆,天生城	万州烤鱼,小面,万州格格,万州古红桔,杂酱面	三峡移民文化节,万州话
青州	仰天山国家森林公园,云门山,黄花溪,范公亭公园,云门山风景区	白肉血肠,杠子头火烧,酸汤子,弥河银瓜,庙子全羊	赵秉忠状元卷,青州花卉博览会,第七届中国花博会,挫琴,花毽
泰安	泰山,东平湖,泰山方特欢乐世界,太阳部落,中华泰山·封禅大典	肥城桃,范镇火烧,东平湖鲤鱼,泰安煎饼,天宝樱桃	石敢当,豫剧,泰山文化,山东梆子,吕剧
淄博	蒲松龄故居,齐国历史博物馆,周村古商城,玉黛湖生态乡村庄园,中国陶瓷馆	糖醋鲤鱼,,豆腐箱,淄川肉烧饼,周村烧饼	杜丽,鲁菜,足球起源地,齐文化,建筑之乡
莆田	光孝寺,湄洲岛,九鲤湖,菜溪岩,湄洲妈祖祖庙	棒棒鸡,荔枝肉,佛跳墙,莆田卤面,莆田煎包	妈祖文化,莆田话,莆仙戏,红砖厝,妈祖阁
西双版纳	雨林谷,野象谷,西双版纳原始森林公园,傣族园,独树成林	香茅草烤鱼,菠萝饭,香竹饭,撒撇,酸笋煮鸡	傣族,开门节,傣族泼水节,傣家竹楼,拉祜族
开封	包公祠,清明上河园,铁塔公园,龙亭公园,开封府	胡辣汤,清汤东坡肉,烩面,羊肉汤,桶子鸡	麒麟舞,七朝古都,开封有个包青天,城摞城,汴绣
邢台	九龙峡,华夏张氏祖庭,北武当山,清风楼,崆山白云洞	巨鹿枸杞,南宫熏菜,威县火烧,三白西瓜,富岗苹果	抬阁,七夕节,邢窑,柏乡汉牡丹花会,梅花拳
信阳	九华山,鸡公山国家级自然保护区,南湾湖,龟山,灵山寺	胡辣汤,麻辣烫,信阳热干面,大肠汤,信阳烤鱼	信阳毛尖,信阳方言,罗山皮影,固始根亲文化节,豫南花鼓戏
湖州	莫干山,竹博园,太湖旅游度假区,下渚湖,新市古镇	干挑面,湖州大馄饨,玫瑰酥糖,千张包,菱湖雪饺	越剧,吴语,滩簧,湖笔,百叶龙
六盘水	坡上草原风景名胜区,六盘水明湖湿地公园,六盘水月照机场,韭菜坪景区,盘县丹霞山	烙锅,羊肉粉,水城羊肉粉,锣锅,荷叶糯米鸡	彝族火把节,彝族,跳花节,凉都六盘水,六枝特区
阜阳	颍州西湖,文峰塔,文峰公园,奎星楼,迪沟生态旅游风景区	油茶,锅贴,格拉条,撒汤,水煎包	中原官话,花鼓灯,民间小调,临泉杂技,阜南柳编
威海	刘公岛,银滩,幸福门,鸡鸣岛,甲午海战纪念馆	坛子肉,鲅鱼饺子,乳山喜饼,葱烧海参,熏鲅鱼	海草房,威海人居节,乳山大秧歌,昆嵛山樱桃节,祭海
汉中	天台山,樱桃沟,圣水寺,褒斜道,勉县武侯墓	汉中面皮,宁强核桃馍,上元观红豆腐,汉中梆梆面,西乡牛肉干	社火,汉语,汉调桄桄,汉王,汉服
承德	承德避暑山庄,坝上草原,鸡冠山,金山岭长城,董存瑞烈士陵园	荞面饸饹,莜面,满汉全席,平泉羊汤,山楂糕	红山文化,承德剪纸,滕氏布糊画,还珠格格,承德木雕
岳阳	洞庭湖,岳阳楼,君山岛,汴河街,金鹗山公园	虾饼,米粉,平江酱干,巴陵全鱼席,兰花萝卜	客家语,赣语,皮影戏,湘语,花鼓戏
潍坊	超然台,沂山风景区,富华游乐园,潍坊世界风筝博物馆,十笏园	肉火烧,潍县萝卜,朝天锅,杠子头火烧,和乐	风筝节,潍坊国际风筝节,赵秉忠状元卷,杨家埠木版年画,龙头蜈蚣
晋江	安平桥,紫帽山,草庵,晋江世纪公园,灵源寺	土笋冻,壶仔饭,深沪鱼丸,绿豆饼,衙口花生	中国鞋都,世界夹克之都,中国陶瓷重镇,中国纺织产业基地,晋江商人
三亚	清补凉,天涯海角,亚龙湾海底世界,雨林谷,蜈支洲岛	东坡饼,椰子饭,海南粉,海南煎粽,神秘果	闽南语,钻木取火,圣纪节,南山佛教文化苑,船形屋
宁波	五龙潭,天宁寺,溪口风景区,天一阁,蒋氏故居	酒酿圆子,青团,宁波汤圆,小笼馒头,猪油汤团	越剧,吴语,舞狮,阳明学派,甬剧
台北	国父纪念馆,台北故宫博物院,台北101,诚品书店,西门町	小笼包,卤肉饭,珍珠奶茶,蚵仔煎,肉圆	妈祖,林志玲,歌仔戏,原住民,祖灵祭
澳门	国父纪念馆,大三巴牌坊,澳门旅游塔,威尼斯人度假村,金莲花广场	葡式蛋挞,猪扒包,木糠布甸,水蟹粥,马介休	妈祖文化,七子之歌,澳门科技大学,澳门艺术节,赌城
长春	般若寺,净月潭,南湖公园,长影世纪城,伪满皇宫	锅包肉,雪衣豆沙,熏肉大饼,朝鲜冷面,酱骨头	文庙,长春国际电影节,长春汽博会,长春农博会,二人转
福州	林则徐纪念馆,文庙,西湖公园,华林寺,三坊七巷	鱼丸,荔枝肉,红烧肉,佛跳墙,福州鱼丸	闽语,寿山石雕,拗九节,福州软木画,闽剧
贵阳	黄果树瀑布,青岩古镇,甲秀楼,息烽温泉,南江大峡谷	酸菜鱼,辣子鸡,宫保鸡丁,丝娃娃,黄粑	刺绣,地戏,跳场,花灯戏,四月八
南宁	青秀山,南宁大桥,加勒比水上世界,广西民族博物馆,芦圩古镇	肠粉,老友粉,肉粽,鱼头豆腐,	壮锦,南宁国际民歌艺术节,歌圩,高脚球,邕剧
长沙	世界之窗,岳麓山,橘子洲,岳麓书院,湘江	辣椒炒肉,口味虾,糖油粑粑,长沙臭豆腐,臭豆腐	湘剧,越剧,刘少奇,胡耀邦,谭嗣同
杭州	西湖,苏堤,苏东坡纪念馆,三潭印月,京杭大运河	东坡肉,小笼包,酒酿圆子,知味小笼,西湖醋鱼	五芳斋,越剧,吴语,西湖龙井,西湖绸伞
南昌	鄱阳湖,滕王阁,安义县,南昌之星,秋水广场	南昌米粉,瓦罐汤,藜蒿炒腊肉,白糖糕,鄱阳湖狮子头	赣语,八一南昌起义,昌大南疆,绳金塔庙会,鄱阳湖螃蟹节
乌鲁木齐	天山,五彩湾,南山牧场,博格达峰,乌鲁木齐人民公园	烤羊肉串,拉条子,丸子汤,馕,新疆大盘鸡	丝绸之路,达瓦孜,姑娘追,叼羊,花帽
呼和浩特	清真大寺,内蒙古博物院,昭君墓,大召寺,大青山野生动物园	手抓羊肉,烤全羊,奶茶,莜面,焖面	蒙古语,二人台,马头琴,那达慕,昭君文化节
拉萨	布达拉宫,纳木错,大昭寺,德宗温泉,拉萨河	牦牛肉,酸奶,酥油茶,青稞酒,糌粑	雪顿节,锅庄舞,沐浴节,藏语,赛马节
天津	鼓楼,望海楼,天津之眼,五大道,梁启超故居	豆腐脑,煎饼果子,津味嘎巴菜,狗不理包子,耳朵眼炸糕	天津泥人张,杨柳青年画,天津快板,天津卫,铁片大鼓
西安	鼓楼,大雁塔,西安城墙,陕西历史博物馆,华清池	胡辣汤,锅盔,臊子面,腊汁肉夹馍,羊肉泡馍	秦腔,皮影戏,长安画派,半坡文化,关中皮影
香港	香港杜莎夫人蜡像馆,维多利亚港,黄大仙,香港海洋公园,香港文华东方酒店	双皮奶,钵仔糕,港式甜品,杨枝甘露,鱼蛋	粤语,金针奖,天坛大佛,香港电影金像奖,黄家强
沈阳	张氏帅府,太清宫,般若寺,新乐遗址,汗王宫	锅包肉,鹿鸣春,羊肝羹,不老林,熏肉大饼	满融村,沈阳羽毛画,北陵公园,葫芦雕,沈阳大秧歌
石家庄	赵州桥,清凉山,世纪公园,抱犊寨,中国皮都	赵州雪花梨,赵府酥鱼,行唐大枣,宫面,饸饹	无极剪纸,辛集农民画,常山战鼓,奚派,丝弦
兰州	黄河母亲,中山桥,白塔山,五泉山,甘肃省博物馆	手抓羊肉,牛肉面,擀面皮,浆水面,羊杂碎	丝绸之路,兰州汉服雅集会,读者,兰州方言,兰州国际马拉松赛
武汉	黄鹤楼,中山公园,武汉长江大桥,户部巷,武大樱花	热干面,武昌鱼,三鲜豆皮,排骨藕汤,鸭脖子	过早,木兰传说,武汉话,汉绣,九省通衢
南京	秦淮河,鼓楼,中山陵,上新河,侵华日军南京大屠杀遇难同胞纪念馆	小笼包,鸭血粉丝汤,口味虾,龙袍蟹黄包,金陵烤鸭	吴语,南京话,高淳话,南京云锦,秦淮灯会
西宁	南禅寺,塔尔寺,小峡,日月山,东关清真大寺	酸奶,手抓羊肉,酿皮,油茶,甜醅	藏羚,皮影戏,花儿,FIRST青年电影展,新石器时代舞蹈纹彩陶盆
济南	九如山瀑布群风景区,趵突泉,大明湖,千佛山,五龙潭	糖醋鲤鱼,坛子肉,油旋,甜沫,九转大肠	济南话,龙山文化,龙山黑陶,新石器时代,鲁绣
合肥	包公祠,渡江战役纪念馆,巢湖,逍遥津,一人巷	曹操鸡,三河米饺,麻饼,烘糕,李鸿章杂烩	黄梅戏,徽剧,药王,庐剧,打香炭
广州	广州塔,珠江,白云山,长隆欢乐世界,上下九步行街	双皮奶,钵仔糕,云吞面,煲仔饭,龟苓膏	粤语,广府文化,早茶,粤菜,粤剧
海口	苏公祠,五公祠,琼山区,琼台书院,府城鼓楼	清补凉,椰子饭,四宝琼山豆腐,海南粉,猪脚饭	闽南语,妈祖文化,换花节,琼剧,军坡节
绥化	绥化西湖公园,望奎县满族风情园,金龟山庄,东富民俗园,绥化庙山	筋饼,东北民猪,烤饼	肇东国画,绥棱黑陶,庆安版画,海伦剪纸,安达奶牛
佳木斯	卧佛山滑雪场,防洪纪念塔,乌苏镇,佳木斯沿江公园,黑龙江洪河国家级自然保护区	星火大米,冷面,三花五罗,北方佳宾白酒,富锦大豆	佳木斯杏花节,佳木斯麻将,三江国际旅游节,赫哲族舞蹈,朝鲜族民俗
成都	武侯祠,天台山,青城山,宽窄巷子,西岭雪山	串串香,麻婆豆腐,担担面,龙抄手,钟水饺	要得,蜀绣,趴耳朵,雄起,八阵图
郑州	少林寺,中原福塔,嵩山,二七纪念塔,方特欢乐世界	豌豆黄,胡辣汤,烩面,羊肉汤,凉粉	豫剧,炎帝,曲剧,郑州城隍庙会,黄帝故里拜祖大典
太原	晋祠,蒙山大佛,太原八景,永祚寺双塔,龙山石窟	老陈醋,羊杂割,六味斋酱肉,清徐葡萄,头脑	清徐社火,太原锣鼓,莲花落,清徐徐沟背铁棍,清徐醋文化节
银川	水洞沟,沙湖,镇北堡影视城,贺兰山岩画,西夏王陵	手抓羊肉,酿皮,油香,烧烤,烩羊杂碎	圣纪节,穆斯林,凤凰城,宁夏银川国际黄河文化节,宁夏坐唱
青岛	中山公园,黄岛金沙滩,八大关,青岛栈桥,崂山	青岛啤酒,青岛高粱饴,辣炒花蛤,崂山绿茶,莱西大板栗	青岛国际啤酒节,青岛樱花会,青岛贝雕,即墨柳腔,胶州秧歌
齐齐哈尔	黑龙江扎龙国家级自然保护区,龙沙公园,齐齐哈尔劳动湖风景区,齐齐哈尔明月岛风景区,金长城遗址公园	齐齐哈尔杀猪菜,克东腐乳,讷河马铃薯,北大仓白酒,泰来大米	克山火山石工艺,齐齐哈尔满绣,达斡尔族刺绣,蒲艺,风刮卜奎
昆明	石林彝族自治县,翠湖,昆明世博园,海埂公园,九乡	过桥米线,小锅米线,玫瑰鲜花饼,烧饵块,干煸洋芋丝	彝族火把节,瓦猫,大观楼长联,竹雕工艺,昆明花灯
哈尔滨	圣·索菲亚教堂,中央大街,龙塔,哈尔滨防洪纪念塔,太阳岛风景名胜区	锅包肉,冰糖葫芦,哈尔滨红肠,冻柿子,杀猪菜	二人转,中国·哈尔滨冰雪大世界,看冰灯,哈尔滨冰灯游园会,俄罗斯工艺品
延安	陕西洛川黄土国家地质公园,清凉山,壶口瀑布,乾坤湾,延安革命纪念馆	荞面饸饹,擀面皮,搅团,油糕,洋芋擦擦	秦腔,安塞腰鼓,陕北窑洞,子长唢呐,信天游
无锡	南禅寺,渡江战役纪念馆,张公洞,徐霞客故居,惠山古镇	酒酿圆子,银鱼炒蛋,清炒虾仁,乌米饭,太湖银鱼	文庙,面塑,小热昏,龙舟竞渡,糖塑
重庆	长江三峡,朝天门,解放碑,酉阳桃花源,大足石刻	酸菜鱼,棒棒鸡,水煮鱼,万州烤鱼,毛血旺	重庆码头文化,梁平竹帘,棒棒儿,摆手舞,川江号子
北京	圆明园,北京故宫,天安门,后海,八达岭长城	老北京宫廷奶酪,老北京涮羊肉,北京烤鸭,老北京炸酱面,驴打滚	京剧,胡同,四合院,卖蝈蝈,烤鸭
大庆	大庆博物馆,铁人王进喜纪念馆,大庆市油田科技馆,龙凤国家湿地公园,石油之光	麻辣香锅,三花五罗,扒鸡,鲟鱼,龙江海米蕨菜	根雕,萨满剪纸,工业版画,蛋雕,蒙古族民歌
阜新	海棠山,张三丰故居,大青沟,海棠山摩崖造像,阜新万人坑死难矿工纪念馆	蒙古馅饼,喇嘛糕,花生,猫耳朵汤,三沟白酒	二人转,藏传佛教,阜新玛瑙雕,蒙古勒津刺绣,阜新蒙古剧
孝感	汤池温泉,白兆山,董永公园,双峰山风景区,古银杏国家森林公园	孝感米酒,孝感麻糖,孝感早蜜桃,二河三蒸,南乡萝卜	楚剧,杨店龙灯,黄孝片,云梦皮影,请七姐